00000000000000000000000000000000
00000113000000000000002000000000
00000111000000000000002000000000
00000111000000001000002000000000
00000111002000000000000000000000
00000222000000000222223330000000
00000000000000000111110000000000
00010000000000000111110000000000
00000000100000000111110000000000
00000000100001000111110000000110
00000000100000000000000000000000
22222222100000000000010000000000
00000000100000000000000000000000
00000100100003333333330000010000
00000000100000000100000000000000
00000000000000000100000000000000
00000000000000000100000000000000
00020000000000344353332344200000
00000000000000200000000000000000
00000000000000100000000000000000
00010001232123540000000000000000
00000000000000000000000001000000
00000000000000000000000000000000
00000000000000222222002222200000
00000000000000200000000000200000
00011111000000200000000000200000
00011111000000200000000000200000
00011111000000200000000000200000
00011111000000200222200222200000
00000000000000000000000000000000
00000000000200000000000000000000
00000000000000000000000000000000